111111111111111111111111111111111111111111111111111111111111111111111111111111
1CCCCCCCCCCC11CCCCCCCCCCC11111111111111111111111111111111111111111111111111111
1C1111C1111C11C1111C1111C11111111111111111111111111111111111111111111111111111
1C1111C1111C11C1111C1111C11111111111111111111111111111111111111111111111111111
1C1111C1111C11C1111C1111C11111111111111111111111111111111111111111111111111111
1CCCCCCCCCCCCCCCCCCCCCCCC11111111111111111111111111111111111111111111111111111
1C1111C1C11111111C1C1111C11111111111111111111111111111111111111111111111111111
1CCCCCC1CCCC11CCCC1CCCCCC11111111111111111111111111111111111111111111111111111
111111C111101101111C1111111111111111111111111111111111111111111111111111111111
111111C100000000001C1111111111111111111111111111111111111111111111111111111111
111111C101110011101C1111111111111111111111111111111111111111111111111111111111
1CCCCCC0010GGGG0100CCCCCE11111111111111111111111111111111111111111111111111111
111111C101111111101C1111111111111111111111111111111111111111111111111111111111
111111C100000000001C1111111111111111111111111111111111111111111111111111111111
111111C101111111101C1111111111111111111111111111111111111111111111111111111111
1CCCCCCCCCCC11CCCCCCCCCCC11111111111111111111111111111111111111111111111111111
1C1111C1111C11C1111C1111C11111111111111111111111111111111111111111111111111111
1CCC11CCCCCC0PCCCCCC11CCC11111111111111111111111111111111111111111111111111111
111C11C1C11111111C1C11C1111111111111111111111111111111111111111111111111111111
1CCCCCC1CCCC11CCCC1CCCCCC11111111111111111111111111111111111111111111111111111
1C111111111C11C111111111C11111111111111111111111111111111111111111111111111111
1CCCCCCCCCCCCCCCCCCCCCCCC11111111111111111111111111111111111111111111111111111
111111111111111111111111111111111111111111111111111111111111111111111111111111
111111111111111111111111111111111111111111111111111111111111111111111111111111
111111111111111111111111111111111111111111111111111111111111111111111111111111
111111111111111111111111111111111111111111111111111111111111111111111111111111
111111111111111111111111111111111111111111111111111111111111111111111111111111
111111111111111111111111111111111111111111111111111111111111111111111111111111
111111111111111111111111111111111111111111111111111111111111111111111111111111
111111111111111111111111111111111111111111111111111111111111111111111111111111
111111111111111111111111111111111111111111111111111111111111111111111111111111
111111111111111111111111111111111111111111111111111111111111111111111111111111
111111111111111111111111111111111111111111111111111111111111111111111111111111
111111111111111111111111111111111111111111111111111111111111111111111111111111
111111111111111111111111111111111111111111111111111111111111111111111111111111
111111111111111111111111111111111111111111111111111111111111111111111111111111
111111111111111111111111111111111111111111111111111111111111111111111111111111
111111111111111111111111111111111111111111111111111111111111111111111111111111
111111111111111111111111111111111111111111111111111111111111111111111111111111
111111111111111111111111111111111111111111111111111111111111111111111111111111
111111111111111111111111111111111111111111111111111111111111111111111111111111
111111111111111111111111111111111111111111111111111111111111111111111111111111
111111111111111111111111111111111111111111111111111111111111111111111111111111
111111111111111111111111111111111111111111111111111111111111111111111111111111
111111111111111111111111111111111111111111111111111111111111111111111111111111